##D##D##
D      #
# BB   #
#     C#
#      #
##D#####
