##########
#       CD
#     E  D
#        #
#       B#
#    BB  #
#       ED
D    E C #
##########
