#####D##
#C     #
D      #
#      D
#      #
#     C#
#C C  B#
##D#####
