###D########
D          #
D     C    #
#   C   CC #
#    B   E D
############
