###D#D####
#    C   #
#B       #
# B  E  C#
#        #
#  E  B  D
#        D
##I#######
