########
#  E   #
#      #
#   BC #
D     E#
#      D
D    EBD
########
