###D#######
#   C   E D
#C        D
#E        #
#         D
# C  C    #
###########
