###########
D         D
#         D
D         #
#         #
#         #
#         #
#         #
###########
